#############################################################################################
#@..#.......................................................................................#
#...........................................................................................#
#####.......................................................................................#
#.........#.................................................................................#
#...........................................................................................#
#...........................................................................................#
#...........................................................................................#
#...........................................................................................#
#...........................................................................................#
#...........................................................................................#
#...........................................................................................#
#...........................................................................................#
#...........................................................................................#
#...........................................................................................#
#...........................................................................................#
#...........................................................................................#
#############################################################################################